tilesheet1.png
6X#20X
14#6
40#24
17
17#17#17#17#17#17#17#17#17#17#17#17#17#17#17#17#17#17#17#17#17#17#17#17#17#17#17#17#17#17#17#17#17#17#17#17#17#17#17#17
17#17#17#17#17#17#17#17#17#17#17#17#17#17#17#17#17#17#17#17#17#17#17#17#17#17#17#17#17#17#17#17#17#17#17#17#17#17#17#17
17#17#17#17#17#17#17#17#17#17#17#17#17#17#17#17#17#17#17#17#17#17#17#17#17#17#17#17#17#17#17#17#17#17#17#17#17#17#17#17
17#17#17#17#17#17#05#06#06#06#06#06#06#06#06#06#06#07#17#17#17#17#17#17#17#17#17#17#17#17#17#17#17#17#17#17#17#17#17#17
17#17#17#17#17#17#33#34#34#34#34#34#34#34#34#34#20#21#17#17#17#17#17#17#17#17#17#17#17#17#17#17#17#17#17#17#17#17#17#17
17#17#17#17#17#17#05#07#05#06#06#06#06#06#06#06#20#21#17#17#05#06#06#06#06#06#06#06#06#06#06#07#17#17#17#17#17#17#17#17
17#17#17#17#17#17#19#21#19#20#34#34#34#34#34#34#34#35#17#17#19#20#34#34#34#34#34#34#34#34#20#21#17#17#17#17#17#17#17#17
17#17#17#17#17#17#19#21#19#21#17#17#17#17#17#17#17#17#17#17#19#21#05#06#06#06#06#06#06#06#20#20#06#07#17#17#17#17#17#17
17#17#17#17#17#17#19#21#19#21#17#17#17#17#17#17#17#17#17#17#19#21#19#20#20#20#34#34#34#34#34#34#20#21#17#17#17#17#17#17
17#17#17#17#17#17#19#20#20#20#06#07#05#06#06#07#05#06#06#06#20#21#19#21#19#21#05#06#06#06#06#07#19#21#17#17#17#17#17#17
17#17#17#17#17#17#33#34#34#34#20#21#19#20#20#21#19#20#34#34#34#35#33#35#19#21#19#20#34#34#20#21#19#21#17#17#17#17#17#17
17#17#17#17#17#17#17#17#17#17#19#21#19#21#19#21#19#20#06#06#06#06#06#07#19#21#19#20#06#07#19#21#19#21#17#17#17#17#17#17
17#17#17#17#17#17#17#17#17#17#19#21#19#21#19#21#19#20#34#34#34#34#20#21#19#21#33#34#34#35#19#21#19#21#17#17#17#17#17#17
17#17#17#17#17#17#17#17#17#17#19#20#20#21#19#21#19#21#05#06#06#07#19#21#19#20#06#06#06#06#20#21#19#21#17#17#17#17#17#17
17#17#17#17#17#17#17#17#17#17#33#34#34#35#19#21#19#21#19#20#20#21#19#21#33#34#34#34#34#34#20#21#19#21#17#17#17#17#17#17
17#17#17#17#17#17#17#17#17#17#17#17#17#17#19#21#19#21#19#21#19#20#20#21#05#06#06#06#06#07#19#21#19#21#17#17#17#17#17#17
17#17#17#17#17#17#17#17#17#17#17#17#17#17#19#21#19#21#19#21#19#20#34#35#19#20#34#34#20#21#19#21#19#21#17#17#17#17#17#17
17#17#17#17#17#17#17#17#17#17#17#17#17#17#19#21#19#21#19#21#19#21#05#06#20#21#05#07#19#21#19#21#19#21#17#17#17#17#17#17
17#17#17#17#17#17#17#17#17#17#17#17#17#17#19#21#19#21#19#21#19#21#19#20#20#21#19#21#19#21#33#35#19#21#17#17#17#17#17#17
17#17#17#17#17#17#17#17#17#17#17#17#17#17#19#20#20#20#20#20#20#20#20#21#19#20#20#21#19#20#06#06#20#21#17#17#17#17#17#17
17#17#17#17#17#17#17#17#17#17#17#17#17#17#33#34#34#34#34#34#34#34#34#35#33#34#34#35#33#34#34#34#34#35#17#17#17#17#17#17
17#17#17#17#17#17#17#17#17#17#17#17#17#17#17#17#17#17#17#17#17#17#17#17#17#17#17#17#17#17#17#17#17#17#17#17#17#17#17#17
17#17#17#17#17#17#17#17#17#17#17#17#17#17#17#17#17#17#17#17#17#17#17#17#17#17#17#17#17#17#17#17#17#17#17#17#17#17#17#17
17#17#17#17#17#17#17#17#17#17#17#17#17#17#17#17#17#17#17#17#17#17#17#17#17#17#17#17#17#17#17#17#17#17#17#17#17#17#17#17
28
InvisibleWall#6X#19X#16X#19X
InvisibleWall#8X#15X#8X#19X
InvisibleWall#12X#11X#12X#15X
InvisibleWall#14X#9X#14X#13X
InvisibleWall#16X#5X#16X#15X
InvisibleWall#22X#17X#30X#17X
InvisibleWall#22X#13X#22X#17X
InvisibleWall#18X#13X#24X#13X
InvisibleWall#18X#5X#18X#11X
InvisibleWall#20X#5X#20X#9X
InvisibleWall#18X#11X#22X#11X
InvisibleWall#22X#9X#22X#11X
InvisibleWall#22X#5X#22X#7X
InvisibleWall#22X#7X#24X#7X
InvisibleWall#24X#7X#24X#15X
InvisibleWall#24X#3X#24X#5X
InvisibleWall#26X#11X#26X#15X
InvisibleWall#26X#5X#26X#7X
InvisibleWall#26X#15X#32X#15X
InvisibleWall#28X#13X#30X#13X
InvisibleWall#26X#11X#30X#11X
InvisibleWall#24X#9X#30X#9X
InvisibleWall#26X#7X#28X#7X
InvisibleWall#28X#3X#28X#7X
InvisibleWall#30X#5X#30X#9X
InvisibleWall#30X#11X#30X#13X
InvisibleWall#32X#5X#32X#15X
InvisibleWall#30X#5X#32X#5X
1
EndingBook#29X#11X
0