tilesheet1.png
6X#18X
14#6
40#24
17
17#17#17#17#17#17#17#17#17#17#17#17#17#17#17#17#17#17#17#17#17#17#17#17#17#17#17#17#17#17#17#17#17#17#17#17#17#17#17#17
17#17#17#17#17#17#17#17#17#17#17#17#17#17#17#17#17#17#17#17#17#17#17#17#17#17#17#17#17#17#17#17#17#17#17#17#17#17#17#17
17#17#17#17#17#17#17#17#17#17#17#17#17#17#17#17#17#17#17#17#17#17#17#17#17#17#17#17#17#17#17#17#17#17#17#17#17#17#17#17
17#17#17#17#17#17#17#17#17#17#17#17#17#17#17#17#17#17#17#17#17#17#17#17#17#17#17#17#17#17#17#17#17#17#17#17#17#17#17#17
17#17#17#17#17#17#17#17#17#17#17#17#17#17#17#17#17#17#17#17#17#17#17#17#17#17#17#17#17#17#17#17#17#17#17#17#17#17#17#17
17#17#17#17#17#17#05#06#06#06#06#06#06#07#17#17#17#17#17#17#17#17#17#17#17#17#17#17#17#17#17#17#17#17#17#17#17#17#17#17
17#17#17#17#17#17#33#34#34#34#34#34#34#21#17#17#17#17#17#17#17#17#17#17#17#17#17#17#17#17#17#17#17#17#17#17#17#17#17#17
17#17#17#17#17#17#17#17#17#17#17#17#05#21#05#06#06#06#06#06#06#06#06#06#06#06#06#06#06#06#06#06#06#07#17#17#17#17#17#17
17#17#17#17#17#17#17#17#17#17#17#17#19#21#19#20#34#34#34#34#34#34#34#34#34#34#34#34#34#34#34#34#20#21#17#17#17#17#17#17
17#17#17#17#17#17#17#17#17#17#17#17#19#21#19#21#05#06#06#06#06#06#06#06#06#06#06#06#06#06#06#07#19#21#17#17#17#17#17#17
17#17#17#17#17#17#17#17#17#17#17#17#19#21#19#21#19#20#34#34#34#34#34#34#34#34#34#34#34#34#20#21#19#21#17#17#17#17#17#17
17#17#17#17#17#17#17#17#17#17#17#17#19#21#19#21#19#21#05#06#06#06#06#06#06#06#06#06#06#07#19#21#19#21#17#17#17#17#17#17
17#17#17#17#17#17#17#17#17#17#17#17#19#21#19#21#19#21#33#34#34#34#34#34#34#34#34#34#34#21#19#21#19#21#17#17#17#17#17#17
17#17#17#17#17#17#17#17#17#17#17#17#19#21#19#21#33#34#32#32#32#32#32#32#32#32#32#32#32#35#19#21#19#21#17#17#17#17#17#17
17#17#17#17#17#17#17#17#17#17#17#17#19#21#19#20#06#06#06#06#06#06#06#06#06#06#06#06#06#06#20#21#19#21#17#17#17#17#17#17
17#17#17#17#17#17#17#17#17#17#17#17#19#21#33#34#34#34#34#34#34#34#34#34#34#34#34#34#34#34#34#35#19#21#17#17#17#17#17#17
17#17#17#17#17#17#17#17#17#17#17#17#19#20#06#06#06#06#06#06#06#06#06#06#06#06#06#06#06#06#06#06#20#21#17#17#17#17#17#17
17#17#17#17#17#17#17#17#17#17#17#17#33#34#34#34#34#34#34#34#34#34#34#34#34#34#34#34#34#34#34#34#34#35#17#17#17#17#17#17
17#17#17#17#17#17#17#17#17#17#17#17#17#17#17#17#17#17#17#17#17#17#17#17#17#17#17#17#17#17#17#17#17#17#17#17#17#17#17#17
17#17#17#17#17#17#17#17#17#17#17#17#17#17#17#17#17#17#17#17#17#17#17#17#17#17#17#17#17#17#17#17#17#17#17#17#17#17#17#17
17#17#17#17#17#17#17#17#17#17#17#17#17#17#17#17#17#17#17#17#17#17#17#17#17#17#17#17#17#17#17#17#17#17#17#17#17#17#17#17
17#17#17#17#17#17#17#17#17#17#17#17#17#17#17#17#17#17#17#17#17#17#17#17#17#17#17#17#17#17#17#17#17#17#17#17#17#17#17#17
17#17#17#17#17#17#17#17#17#17#17#17#17#17#17#17#17#17#17#17#17#17#17#17#17#17#17#17#17#17#17#17#17#17#17#17#17#17#17#17
17#17#17#17#17#17#17#17#17#17#17#17#17#17#17#17#17#17#17#17#17#17#17#17#17#17#17#17#17#17#17#17#17#17#17#17#17#17#17#17
25
InvisibleWall#12X#17X#13X#17X
InvisibleWall#14X#8X#14X#17X
InvisibleWall#14X#8X#32X#8X
InvisibleWall#32X#8X#32X#15X
InvisibleWall#16X#15X#32X#15X
InvisibleWall#16X#10X#16X#15X
InvisibleWall#16X#10X#30X#10X
InvisibleWall#30X#10X#30X#13X
InvisibleWall#18X#13X#30X#13X
InvisibleWall#18X#11X#18X#13X
InvisibleWall#18X#11X#29X#11X
Door#13X#528#false#1
Door#944#16X#true#5
Door#944#15X#true#-1
Door#816#16X#true#-1
Door#816#15X#true#6
Door#688#16X#true#6,10
Door#688#15X#true#10
Door#560#16X#true#7
Door#560#15X#true#7
Door#528#16X#true#7
Door#528#15X#true#7
Door#496#16X#true#7
Door#496#15X#true#7
Door#912#10X#true#9
28
FloorButton#10X#18X#1
FloorButton#12X#11X#2
FloorButton#29X#07X#3
FloorButton#32X#12X#4
FloorButton#32X#16X#5
FloorButton#28X#15X#6
FloorButton#24X#15X#10
FloorButton#20X#15X#7
FloorButton#31X#08X#8
FloorButton#17X#10X#9
FloorButton#18X#10X#9
FloorButton#19X#10X#9
FloorButton#20X#10X#9
FloorButton#21X#10X#9
FloorButton#22X#10X#9
FloorButton#23X#10X#9
FloorButton#24X#10X#9
FloorButton#25X#10X#9
FloorButton#26X#10X#9
FloorButton#27X#10X#9
EndingBook#23X#11X
LaserShooter#12X#9X#14X#9X#2#Up#6X#90
LaserShooter#15X#6X#15X#8X#3#Right#16X#90
LaserShooter#32X#8X#34X#8X#4#Up#6X#90
LaserShooter#16X#8X#18X#8X#8#Up#1X#15
LaserShooter#20X#9X#22X#9X#8#Down#1X#15
LaserShooter#24X#8X#26X#8X#8#Up#1X#15
LaserShooter#28X#9X#30X#9X#8#Down#1X#15
0